*****************************************
*........**...****....*******************
*.**.***.**.*.**....*.................***
*.**.***....*.**.**.***.*************.***
*.**.....****............********......**
*.**.*.*.****.******.************.****.**
*....*.*......******.************.****.**
*.****.***.*****.....***.********.****.**
*.****..**.*****.***.***....***....******
*....**.**.*****.***.....**.*.*.**.****.*
*.**.**....*********.**..**.*.*.**......*
*.**.*****.*****.*******........**.***.**
*..........*****.*******.******.**.***.**
*****.***.*****.............. *.*.......*
*.....***.***...********.***.**.*.*****.*
*.*******.*...**********.*.*.**.*.***.*.*
*.*.......******.*******.*.*.**.*.....*.*
*...*****.....****............*.*******.*
*.*******.***......*******.****.........*
*****************************************
