*****************************************
*.....*.........*...*.......*.........*.*
***.*******.***.***.*.***.*.*.***.*****.*
*.*.*...*.*...*.*...*.*.*.*.*...*...*...*
*.*.*.***.***.*****.***.*.***.*****.*.***
*.........*.*...*.*...............*.*...*
*.*********.*.*.*.*****.*****.*******.*.*
*...*...*.*...*.*.......*.....*.*...*.*.*
***.***.*.*****.***.***.*.***.*.***.***.*
*.......*.............*.*...*...*.....*.*
*.*.*****.*.***.*********.***.***.*****.*
*.*.*.....*.*.....*.*.*.....*.......*...*
*.*******.***.***.*.*.*.*****.***.*.***.*
*.......*...*.*.......*.*.*...*...*.....*
*.*****.***********.*.*.*.*****.*********
*.*.*.....*.*...*...*.*.*.......*.......*
*.*.*****.*.*.***.*****.*******.***.*.***
*...*...*.....*...*.........*.....*.*...*
*.*****.*.*****.***.*.*.*****.*.*****.*.*
*****************************************
